#######################
#..........#..........#
#o###.####.#.####.###o#
#.###.####.#.####.###.#
#.....................#
#.###......B......###.#
#.....#.###+###.#.....#
#####.#.#  P  #.#.#####
#####.#.#######.#.#####
#####.#         #.#####
#####.# ..###...#.#####
<    .  ..........    >
#####.# ###.###.#.#####
#####.#         #.#####
#####.#.###+###.#.#####
#####.#.# I C #.#.#####
#.....#.#######.#.....#
#.###.............###.#
#o..#...... ......#..o#
###.#.#.#######.#.#.###
#.....#....#....#.....#
#.########.#.########.#
#.########.#.########.#
#.....................#
#######################
